AA	AA_pmids_tagged.arff	2
ADA	ADA_pmids_tagged.arff	2
ADH	ADH_pmids_tagged.arff	2
ADP	ADP_pmids_tagged.arff	2
Adrenal	Adrenal_pmids_tagged.arff	2
Ala	Ala_pmids_tagged.arff	3
ALS	ALS_pmids_tagged.arff	2
ANA	ANA_pmids_tagged.arff	2
Astragalus	Astragalus_pmids_tagged.arff	2
BAT	BAT_pmids_tagged.arff	2
BLM	BLM_pmids_tagged.arff	2
Borrelia	Borrelia_pmids_tagged.arff	2
BPD	BPD_pmids_tagged.arff	2
BR	BR_pmids_tagged.arff	2
BSA	BSA_pmids_tagged.arff	2
BSE	BSE_pmids_tagged.arff	2
Ca	Ca_pmids_tagged.arff	4
CAD	CAD_pmids_tagged.arff	2
Callus	Callus_pmids_tagged.arff	2
CAM	CAM_pmids_tagged.arff	2
CCD	CCD_pmids_tagged.arff	2
CCl4	CCl4_pmids_tagged.arff	2
CDA	CDA_pmids_tagged.arff	2
CDR	CDR_pmids_tagged.arff	2
Cell	Cell_pmids_tagged.arff	2
Cement	Cement_pmids_tagged.arff	2
CH	CH_pmids_tagged.arff	2
Cholera	Cholera_pmids_tagged.arff	2
CI	CI_pmids_tagged.arff	2
Cilia	Cilia_pmids_tagged.arff	2
CIS	CIS_pmids_tagged.arff	2
CLS	CLS_pmids_tagged.arff	2
CNS	CNS_pmids_tagged.arff	2
Coffee	Coffee_pmids_tagged.arff	2
Cold	Cold_pmids_tagged.arff	3
Compliance	Compliance_pmids_tagged.arff	2
Cortex	Cortex_pmids_tagged.arff	2
Cortical	Cortical_pmids_tagged.arff	3
CP	CP_pmids_tagged.arff	3
CPDD	CPDD_pmids_tagged.arff	2
Crack	Crack_pmids_tagged.arff	2
CRF	CRF_pmids_tagged.arff	2
cRNA	cRNA_pmids_tagged.arff	2
Crown	Crown_pmids_tagged.arff	2
CTX	CTX_pmids_tagged.arff	2
DAT	DAT_pmids_tagged.arff	2
DBA	DBA_pmids_tagged.arff	2
dC	dC_pmids_tagged.arff	2
DDD	DDD_pmids_tagged.arff	2
DDS	DDS_pmids_tagged.arff	3
DE	DE_pmids_tagged.arff	2
DI	DI_pmids_tagged.arff	2
Digestive	Digestive_pmids_tagged.arff	2
DON	DON_pmids_tagged.arff	2
drinking	drinking_pmids_tagged.arff	2
eCG	eCG_pmids_tagged.arff	2
Eels	Eels_pmids_tagged.arff	2
EGG	EGG_pmids_tagged.arff	2
EM	EM_pmids_tagged.arff	2
EMS	EMS_pmids_tagged.arff	2
Epi	Epi_pmids_tagged.arff	2
ERP	ERP_pmids_tagged.arff	2
ERUPTION	ERUPTION_pmids_tagged.arff	2
Erythrocytes	Erythrocytes_pmids_tagged.arff	2
Exercises	Exercises_pmids_tagged.arff	2
FA	FA_pmids_tagged.arff	2
FAS	FAS_pmids_tagged.arff	2
Fe	Fe_pmids_tagged.arff	2
Fish	Fish_pmids_tagged.arff	2
Follicle	Follicle_pmids_tagged.arff	2
Follicles	Follicles_pmids_tagged.arff	2
FTC	FTC_pmids_tagged.arff	2
GAG	GAG_pmids_tagged.arff	2
Gamma-Interferon	Gamma-Interferon_pmids_tagged.arff	2
Ganglion	Ganglion_pmids_tagged.arff	2
Gas	Gas_pmids_tagged.arff	2
Glycoside	Glycoside_pmids_tagged.arff	2
HCl	HCl_pmids_tagged.arff	2
Hemlock	Hemlock_pmids_tagged.arff	2
Heregulin	Heregulin_pmids_tagged.arff	2
HGF	HGF_pmids_tagged.arff	2
Hip	Hip_pmids_tagged.arff	2
HIV	HIV_pmids_tagged.arff	2
HPS	HPS_pmids_tagged.arff	2
HR	HR_pmids_tagged.arff	2
Hybridization	Hybridization_pmids_tagged.arff	2
IA	IA_pmids_tagged.arff	2
Ice	Ice_pmids_tagged.arff	3
INDO	INDO_pmids_tagged.arff	2
Ion	Ion_pmids_tagged.arff	2
IP	IP_pmids_tagged.arff	2
Iris	Iris_pmids_tagged.arff	2
ITP	ITP_pmids_tagged.arff	2
JP	JP_pmids_tagged.arff	2
LABOR	LABOR_pmids_tagged.arff	2
Lactation	Lactation_pmids_tagged.arff	2
Language	Language_pmids_tagged.arff	2
Laryngeal	Laryngeal_pmids_tagged.arff	2
Lawsonia	Lawsonia_pmids_tagged.arff	2
Leishmaniasis	Leishmaniasis_pmids_tagged.arff	2
lens	lens_pmids_tagged.arff	3
Lupus	Lupus_pmids_tagged.arff	3
lymphogranulomatosis	lymphogranulomatosis_pmids_tagged.arff	2
MAF	MAF_pmids_tagged.arff	2
Malaria	Malaria_pmids_tagged.arff	2
MBP	MBP_pmids_tagged.arff	2
MCC	MCC_pmids_tagged.arff	2
Medullary	Medullary_pmids_tagged.arff	2
MHC	MHC_pmids_tagged.arff	2
Milk	Milk_pmids_tagged.arff	2
Moles	Moles_pmids_tagged.arff	2
MRS	MRS_pmids_tagged.arff	2
NBS	NBS_pmids_tagged.arff	2
NEUROFIBROMATOSIS	NEUROFIBROMATOSIS_pmids_tagged.arff	2
NM	NM_pmids_tagged.arff	2
NPC	NPC_pmids_tagged.arff	2
Nurse	Nurse_pmids_tagged.arff	2
Nursing	Nursing_pmids_tagged.arff	2
OCD	OCD_pmids_tagged.arff	2
OH	OH_pmids_tagged.arff	2
Orf	Orf_pmids_tagged.arff	2
ORI	ORI_pmids_tagged.arff	2
PAC	PAC_pmids_tagged.arff	2
PAF	PAF_pmids_tagged.arff	2
Parotitis	Parotitis_pmids_tagged.arff	2
PCA	PCA_pmids_tagged.arff	5
PCB	PCB_pmids_tagged.arff	2
PCD	PCD_pmids_tagged.arff	2
PCP	PCP_pmids_tagged.arff	3
PEP	PEP_pmids_tagged.arff	2
PHA	PHA_pmids_tagged.arff	2
Pharmaceutical	Pharmaceutical_pmids_tagged.arff	2
Phosphorus	Phosphorus_pmids_tagged.arff	2
Phosphorylase	Phosphorylase_pmids_tagged.arff	2
pI	pI_pmids_tagged.arff	2
Plague	Plague_pmids_tagged.arff	2
Plaque	Plaque_pmids_tagged.arff	2
Platelet	Platelet_pmids_tagged.arff	2
Pleuropneumonia	Pleuropneumonia_pmids_tagged.arff	2
Pneumocystis	Pneumocystis_pmids_tagged.arff	2
POL	POL_pmids_tagged.arff	2
Potassium	Potassium_pmids_tagged.arff	2
PR	PR_pmids_tagged.arff	2
Projection	Projection_pmids_tagged.arff	2
PVC	PVC_pmids_tagged.arff	2
RA	RA_pmids_tagged.arff	3
Radiation	Radiation_pmids_tagged.arff	2
RB	RB_pmids_tagged.arff	2
RBC	RBC_pmids_tagged.arff	2
rDNA	rDNA_pmids_tagged.arff	2
README.txt	README.txt	1
Respiration	Respiration_pmids_tagged.arff	2
Retinal	Retinal_pmids_tagged.arff	2
Root	Root_pmids_tagged.arff	2
RSV	RSV_pmids_tagged.arff	2
SARS	SARS_pmids_tagged.arff	2
SCD	SCD_pmids_tagged.arff	2
Semen	Semen_pmids_tagged.arff	2
SLS	SLS_pmids_tagged.arff	2
Sodium	Sodium_pmids_tagged.arff	2
SPR	SPR_pmids_tagged.arff	2
SS	SS_pmids_tagged.arff	2
Staph	Staph_pmids_tagged.arff	2
STEM	STEM_pmids_tagged.arff	2
Sterilization	Sterilization_pmids_tagged.arff	2
Strep	Strep_pmids_tagged.arff	2
Synapsis	Synapsis_pmids_tagged.arff	2
TAT	TAT_pmids_tagged.arff	3
Tax	Tax_pmids_tagged.arff	2
TEM	TEM_pmids_tagged.arff	2
THYMUS	THYMUS_pmids_tagged.arff	3
TLC	TLC_pmids_tagged.arff	2
TMJ	TMJ_pmids_tagged.arff	2
TMP	TMP_pmids_tagged.arff	2
TNC	TNC_pmids_tagged.arff	2
TNT	TNT_pmids_tagged.arff	2
Tolerance	Tolerance_pmids_tagged.arff	2
tomography	tomography_pmids_tagged.arff	2
Torula	Torula_pmids_tagged.arff	2
TPA	TPA_pmids_tagged.arff	2
TPO	TPO_pmids_tagged.arff	2
TRF	TRF_pmids_tagged.arff	2
TSF	TSF_pmids_tagged.arff	2
TYR	TYR_pmids_tagged.arff	2
US	US_pmids_tagged.arff	2
ventricle	ventricle_pmids_tagged.arff	2
veterinary	veterinary_pmids_tagged.arff	2
Wasp	Wasp_pmids_tagged.arff	2
WBS	WBS_pmids_tagged.arff	2
WT1	WT1_pmids_tagged.arff	2
